//id, hp, mp, str, def, agi
0, 5, 3, 5, 3, 3
1, 4, 4, 4, 4, 3
2, 3, 5, 3, 5, 3
3, 3, 3, 3, 3, 3
4, 3, 3, 3, 3, 3